g g g g g g g g g r r r
g g r r g r r g g r r r
g g r r g r g g r r g r
g g g g g g g g r g g r
g g r g g g g g r g g r
g g g g w w w g g g g r
g g g g w w w r g g g r
g g g w w g g r g g g r
r r g w w w g g g g r r
g r g g g g g g g g g r
g r g g g g g g g g g r
r r r r r r r r r r r r
