g g g g g g g g g w w w
g g g g g g g g g w w w
g g r r r r g g g w w w
g g r g g r g g g g g g
g g r g g r g g g g g g
g g r r r r g r g g g g
g g g g g g g r g g g g
g g g g g r r r g g g g
g g w w w w r g g w w g
g g w w w w w r g w w g
g g w w w w w g g g g g
g g g g w w w g g g g g
